[size=7]
[r=0.5625,g=0.9375,y=1]

[{0 0 0 0 0 0 0}
{0 0 0 0 0 0 0}
{0 0 r r r 0 0}
{0 0 r r r 0 0}
{0 0 r r r 0 0}
{0 0 0 0 0 0 0}
{0 0 0 0 0 0 0}]

[{0 0 0 0 0 0 0}
{0 0 0 0 0 0 0}
{0 0 0 0 0 0 0}
{0 0 0 g 0 0 0}
{0 0 0 0 0 0 0}
{0 0 0 0 0 0 0}
{0 0 0 0 0 0 0}]

[{0 0 0 0 0 0 0}
{0 0 0 0 0 0 0}
{0 0 0 0 0 0 0}
{0 0 0 g g 0 0}
{0 0 0 0 0 0 0}
{0 0 0 0 0 0 0}
{0 0 0 0 0 0 0}]

[{0 0 0 0 0 0 0}
{0 0 0 0 0 0 0}
{0 0 0 0 0 0 0}
{0 0 0 g 0 0 0}
{0 0 0 0 0 0 0}
{0 0 0 0 0 0 0}
{0 0 0 0 0 0 0}]

[{0 0 0 0 0 0 0}
{0 0 0 0 0 0 0}
{0 0 0 0 0 0 0}
{0 0 g g 0 0 0}
{0 0 0 0 0 0 0}
{0 0 0 0 0 0 0}
{0 0 0 0 0 0 0}]

[{0 0 0 0 0 0 0}
{0 0 0 0 0 0 0}
{0 0 0 0 0 0 0}
{0 0 0 y 0 0 0}
{0 0 0 0 0 0 0}
{0 0 0 0 0 0 0}
{0 0 0 0 0 0 0}]

[{0 0 0 0 0 0 0}
{0 0 0 0 0 0 0}
{0 0 0 0 0 0 0}
{0 0 0 0 0 0 0}
{0 0 0 0 0 0 0}
{0 0 0 0 0 0 0}
{0 0 0 0 0 0 0}]