[size=7]

[{0 0 0 0 0 0 0}
{0 0 0 0 0 0 0}
{0 0 y r b 0 0}
{0 0 y r b 0 0}
{0 0 y r b 0 0}
{0 0 0 0 0 0 0}
{0 0 0 0 0 0 0}]

[{0 0 0 0 0 0 0}
{0 0 0 0 0 0 0}
{0 o o 0 o o 0}
{0 o o 0 o o 0}
{0 o o 0 o o 0}
{0 0 0 0 0 0 0}
{0 0 0 0 0 0 0}]

[{0 0 0 0 0 0 0}
{0 0 0 0 0 0 0}
{g p 0 0 0 p g}
{g p 0 0 0 p g}
{g p 0 0 0 p g}
{0 0 0 0 0 0 0}
{0 0 0 0 0 0 0}]

[{0 0 0 0 0 0 0}
{0 0 0 0 0 0 0}
{0 0 0 0 0 0 0}
{0 0 0 0 0 0 0}
{0 0 0 0 0 0 0}
{0 0 0 0 0 0 0}
{0 0 0 0 0 0 0}]

[{0 0 0 0 0 0 0}
{0 0 0 0 0 0 0}
{0 0 0 0 0 0 0}
{0 0 0 0 0 0 0}
{0 0 0 0 0 0 0}
{0 0 0 0 0 0 0}
{0 0 0 0 0 0 0}]

[{0 0 0 0 0 0 0}
{0 0 0 0 0 0 0}
{0 0 0 0 0 0 0}
{0 0 0 0 0 0 0}
{0 0 0 0 0 0 0}
{0 0 0 0 0 0 0}
{0 0 0 0 0 0 0}]

[{0 0 0 0 0 0 0}
{0 0 0 0 0 0 0}
{0 0 0 0 0 0 0}
{0 0 0 0 0 0 0}
{0 0 0 0 0 0 0}
{0 0 0 0 0 0 0}
{0 0 0 0 0 0 0}]